20
################################################################################
#..............................................................................#
#........x.........O.......O...................................................#
#....P............x..............O...OOO...................x...................#
#......................x....OOO................................................#
#============================================..................................#
#.........O....................................................................#
#....................................x......................x..................#
#.................x.................................................=======....#
#..................x................................................=xxOOO.....#
#............x...............O...................O..................=xxxOO.....#
#...................................................................=xxxxO.....#
#.....................x......................................==============....#
#............................................................=.................#
#........................            ........................=.................#
#........................  xxxxxxxx  ..........................................#
#........O............... .......... ..........................................#
#........O...............      W     ..........................................#
#........O...............            ..........................................#
#........O...............  x  x   x  ..........................................#
#........................ .......... ................O.........................#
#........................      W     ..............OOOOOOOO....................#
#........................            ...........OOOOOxxxxxOOOOO................#
#........................   x x  x   .............OOOxxxxxOOOO.................#
#........................ .......... .................OOO......................#
#........................      W     ..........................................#
#..............................      ..........................................#
#..............................................................................#
#..................========......................          W     ..............#
#.........======....OOxOO==......................                ..............#
#.........=...............=...........x..........                .....x........#
#.........=.O.....O.......=........xxx...........                .....x........#
#.........=...x......x....=.........x............               W......x.......#
#.........=...............=......................                ..............#
#.........=..O...x....O...=......................                ..............#
#.........=...............=....................................................#
#.........=================....................................................#
#..............................................................................#
#..............................................................................#
################################################################################


