######################## keep this line! #######################################
40x22
########################################
#......................................#
#..P.....x.............................#
#................................O...OO#
#......................................#
#.......OO.............................#
#.........O............................#
#....................................x.#
#.................x....................#
#..................x...................#
#............x.........................#
#.............................x........#
#.....................O................#
#......................................#
#......................................#
#......................................#
#........O.............................#
#........O.............................2
#........O.............................#
#........O.............................#
#........................      X     ..#
########################################
gems=8

