######################## keep this line! #######################################
40x22
########################################
#.................. ..=================#
#..   .........O.OO====                2
#.. .............OO            xOxxOxxx#
#................OO==== xxxOxxOOOxxxxOO#
#.......OOO.........  =================#
#.......OOO............................#
#.......=.=...................OOO....x.#
#.......= =.......x...........OOO......#
#.....=== ===......x..........=.=......#
#.....=     =x...............x= ==.....#
#.O...=xxOxx=................== ==.....#
#. ...=xxxOx=.........O......=   =.....#
#. ...=Oxxxx=................=xxx=.....#
#. ...=xxxxO=.....O..........=Oxx=.....#
#. ...=======..... ..........=xxO=.....#
#........O........  .........=xOx=.....#
#........ ...................=xxx=.....#
#............................=====.....#
#........O......P......................#
#......................................#
########################################
gems=45

