######################## keep this line! #######################################
40x22
########################################
#....xx=xx...x=..  xx=......=......=...#
#.....O=.x....=xx  xx=......=......=...#
#xx... =......=..  ..=.. ...=....O.=.OO#
#..... =......=....x.=..B...=......=...#
#..... =OO....=x.....=.. ...=......=...#
# .....=xxO...=..x...=      =......=...#
# .....=.. ...=......=.. ...=......=.x.#
#B.....=.. ...= B    =..B...=......=...#
# x....=.. ...=....x.=.. ...=......=...#
# ..O..=.. ..x=......=......=......=...#
#......=......=....x.=......=.x....=...#
#... ..=....O.=.x..O.=O.....=......=...#
#..  ..=...OO.=......=xx....=......=...#
#.....O=......=      =xx....=......=...#
#=....=.=....=O=    =.=....=.=....=....#
#.=..=...=..=...=  =...=..=...=..=.....#
#........O.............................2
#......................................#
#..P......  ..................... B....#
#....  B ........................  ....#
########################################
gems=28

