######################## keep this line! #######################################
40x22
#####################################2##
#....xx=xx...x=..  xx=......=......=...#
#.....O=.x....=xx  xx=......=......=...#
#xx... =......=..  ..=.. ...=....O.=.OO#
#..... =......=....x.=..W...=......=...#
#..... =OO....=x.....=.. ...=......=...#
# .....=xxO...=..x...=      =......=...#
# .....=.. ...=......=.. ...=......=.x.#
#W.....=.. ...= W    =..W...=......=...#
# x....=.. ...=....x.=.. ...=......=...#
# ..O..=.. ..x=......=......=......=...#
#......=......=....x.=......=.x....=...#
#... ..=....O.=.x..O.=O.....=......=...#
#..  ..=...OO.=......=xx....=......=...#
#.....O=......=      =xx....=......=...#
#=....=.=....=O=    =.=....=.=....=....#
#.=..=...=..=...=  =...=..=...=..=.....#
#........O.............................2
#......................................#
#..P......  ..................... W....#
#....  W ........................  ....#
########################################
gems=28

