######################## keep this line! #######################################
40x22
########################################
#............O....................   ..#
#..P.....x.......... W     ......  ....#
#.......O........................O...OO#
#....... O......  ....   ............. #
#.......  ............ ............... #
#================================..... #
#O........ ...O.................=....x.#
# ..O  .... ......x ...O     ...=......#
#O.........O.......x............=.... .#
# .....====================.....=...  .#
# .....=xx..O..#####......=...x.=.O....#
# .....=OO.. ..##2##..O...=.....=......#
# .....=.... ............O=.....=O.....#
# .....=.... .....  ............=......#
# . ...==========================......#
# .......O....O..  ....................#
# .......O.................O O.........#
#........O......................... ...#
#........O......... ...................#
#... ..............  ....      X     ..#
########################################
gems=5

