######################## keep this line! #######################################
40x22
########################################
#................. ....................#
#........x......   ....................#
#.......P........................O...OO#
#.. ...................................#
#.. ...                         .......#
#.   .. ....................... .......#
#...... .==========O==========. .....x.#
#...... .=........x..........=. .......#
#..O... .=....O....*.........=. .......#
#...... .O...x....***........O. .......#
#...... .=......O..*.........=x .......#
#...O.. .=............O......=. .......#
#...... .==========O==========. .......#
#...... ....................... .......#
#...... B  B  B  B  B  B  B  B  .......#
#......................................#
#........O.............................2
#........ O............................#
#........O.............................#
#......................................#
########################################
gems=95

